11111111111111111111111
1P00000C000C00000CE0CC1
11111111111111111111111
