1111111111
1P00000001
1000E00001
10C0000101
1111111111
