111111
100001
10C0E1
100001
111111
