111111
100011
10C1E1
100101
111111
