1111111111
1P1E110001
1000010001
10C0000101
1111111111
