1111111111
1P1E110001
10000100C1
1000C00101
1111111111
