11111111111111111111111
1C00010000000100C000001
10000100000000000000001
1101110000111100C000001
10000000001111000000001
1111111100011100P000001
1C010000000001000000001
10000000000001000000001
11011100001111000000001
10000000000C000000C0001
11111111111111111111111
